NO ./text/wall.xpm
SO ./text/wall.xpm
WE ./text/wall.xpm
EA ./text/wall.xpm

F 255,0,0
C 255,255,255

1111111111111111111111111
1000000000110000000000001
1011000001110000000000001
1001000000000000000000001
100000S000000000000000001
1000000000000000000000001
1111000100000000000000001
1111000111111111111111111
11000001
10000001
10000001
11000001
11110111
11111111